1 1 1 1 1 1 1 1
3 0 0 0 0 0 0 1
3 0 0 0 0 0 0 2
3 0 0 0 0 0 0 2
3 0 0 0 0 0 0 2
3 0 0 0 0 0 0 2
3 0 0 0 0 0 0 2
3 0 0 0 0 0 0 2
3 0 0 4 4 4 4 1
3 0 0 0 0 0 0 2
3 0 0 0 0 0 0 2
3 0 0 0 0 0 0 2
3 0 0 0 0 0 0 2
1 6 6 6 6 6 6 1
5 0 0 0 0 0 0 5
5 0 0 0 0 0 0 5
5 0 0 0 0 0 0 5
5 0 0 0 0 0 0 5
5 0 0 0 0 0 0 5
5 0 0 0 0 0 0 5
5 0 0 0 0 0 0 5
5 0 0 0 0 0 0 5
5 0 0 0 0 0 0 5
5 5 5 5 5 5 5 5
